d00mmmmm0m00mmm
00m0000m0mm0m00
m00m0m000m0000m
m000mm00000mmmm
000m00000mmm00m
mm0mmmm0mm000mm
000mmm0000mmmmm
0m000mm0m0mm00m
0mm0m000m000mmm
0mm00m0mm000000
0mm0mm0000mm00m
0000m00m0mm00mm
0mmm00m00000mmm
0mmm0mmm0mm0mmm
00000mmm00m000a
